5 13 31
###############################
# p       x                   #
#  f              #           #
#  b                          #
#  DB   s f             *     #
#      W         f            #
#                    *        #
#                    1        #
#   3                         #
#     4     F     2     *     #
#            *    f           #
#     5                 b  q  #
###############################



# - Wall
* - Brick
x - Portal

p - Player1
q - Player2
1 - Balloon
2 - Oneal
3 - Doll
4 - Minvo
5 - Kondoria


b - Bomb Item
B - BombPass Item
f - Flame Item
F - FlamePass Item
s - Speed Item
W - WallPass Item
D - Detonator Item
