0 13 31
###############################
# p   bBDfFsW    x            #
#                 #           #
#  *              ****        #
#     ****             *      #
#    ****        f            #
#                    *        #
#           *        1        #
#   3                         #
#     4    ****     2     *   #
#            *                #
#     5                    q  #
###############################



# - Wall
* - Brick
x - Portal

p - Player1
q - Player2
1 - Balloon
2 - Oneal
3 - Doll
4 - Minvo
5 - Kondoria


b - Bomb Item
B - BombPass Item
f - Flame Item
F - FlamePass Item
s - Speed Item
W - WallPass Item
D - Detonator Item
