4 13 31
###############################
#p     ** * 1  *   *  * * *   #
# #*# #*# # #x#*# # # #*#*#*# #
#   *    4***  *  3   *   * * #
# #D# #*# #*# # #*#*# #f# # #*#
#f     1     **  *  *   2     #
# #*# #F#*# #s# # #*# #*# # # #
#*  *    2 *  *   1  *   4    #
# # # # #*# #b# #*#*# # #x# # #
#* 3  **  *       *      5    #
# #*# # # #W# # #*# #*# #*# # #
#       5   *   *  *   *  q   #
###############################


# - Wall
* - Brick
x - Portal

p - Player1
q - Player2
1 - Balloon
2 - Oneal
3 - Doll
4 - Minvo
5 - Kondoria


b - Bomb Item
B - BombPass Item
f - Flame Item
F - FlamePass Item
s - Speed Item
W - WallPass Item
D - Detonator Item