3 13 31
###############################
#p    *x* *  1 *   *  * * *   #
# # # #*# # #*#*# # # #*#*#*# #
#   *    b*** D*      *   * * #
# # # # # #*# # #*#*# # # # #*#
#f       2   **  *  *    4    #
# # # # # # # # # #*# #*# # # #
#*  *  4   * B*      *    2   #
# # # # #*# # #F#*#*# # # # # #
#*    **  *   1   *      3    #
# #*# # # # # # #*# # # # # # #
#        1  *   *  *        q #
###############################



# - Wall
* - Brick
x - Portal

p - Player1
q - Player2
1 - Balloon
2 - Oneal
3 - Doll
4 - Minvo
5 - Kondoria


b - Bomb Item
B - BombPass Item
f - Flame Item
F - FlamePass Item
s - Speed Item
W - WallPass Item
D - Detonator Item